00000000000000000000
00000000000000000000
00001111111110000000
00000000000000000000
01111100000001111111
00000000100000000000
00000000000000000000
00000111112000000000
00001100000111111000
00000000000000000000
11100000000000000000
00011000000000000311
00001100000000003111
11111111111111111111
