00000000000000000000
00000000000000000000
00000000100000000000
00000000100000000000
00000000000000001000
00000000100000001000
00000000100000001000
00000000010000000000
00000000010000000000
00000000010000000000
01000000010000000000
01000000010000000000
01000000010000000000
00000000000000000000